AlienGlowTextEffect=bg
AnimatedGifBackground=ay
AnimationContainerView=bh
ArrayList=aq
Background=a
BallBackground=b
BinaryTextClockView=bi
Border=c
BorderedRoundRectBackground=d
BorderedRoundRectOpeningBackground=e
BorderedRoundTabBackground=f
BorderedSimpleBackground=g
BottomBorder=h
BottomRightShadowBorder=i
CarouselContainerView=bj
CircleBackground=j
CircleBorder=k
Color=l
CombinedBackground=az
ContainerView=bk
CyclingIconsGaugeView=bl
CyclingSpheresGaugeView=bm
DoubleGradientVerticalBackground=ar
DropShadowBorder=m
DropShadowTextEffect=bo
DroppingView=bn
ExclusiveSingleLineView=bp
ExplodingParticlesItemView=bq
FadeInBackground=n
FadeInItemView=br
FadeOutItemView=bs
FadeTextEffect=bt
FadingAlienGlowTextEffect=bu
FishEyeContainerView=bv
FlashTextEffect=bw
GradientVerticalBackground=o
HexTextClockView=bx
HorizontalChoiceView=by
HorizontalContainerView=bz
HorizontalGrayOutContainerView=ca
HorizontalIconsGaugeView=cb
HorizontalSpheresGaugeView=cc
HorizontalStripesBackground=p
ImageBackground=q
ImageBorder=r
IntList=as
IntStack=at
ItemView=cd
LeftBorder=s
LighthouseTextEffect=ce
MIDP2LayoutView=cf
MaskBackground=ba
MultiImageBorder=t
NumberedContainerView=cg
OpeningBackground=u
OutlineTextEffect=ch
PartialGradientBackground=ci
PartialSimpleBackground=cj
PieChartView=ck
Point=bb
PolygonBackground=bc
Properties=ap
PulsatingBackground=v
PulsatingCircleBackground=w
PulsatingCirclesBackground=x
PulsatingRoundRectBackground=au
PulsatingRoundRectBorder=av
PulsatingSimpleBorder=aw
RecLineGaugeView=cl
RelativeLayoutView=cm
RepaintTestBackground=ax
RightBorder=y
RotateTextEffect=cn
RotatingArcsGaugeView=co
RotatingTextEffect=cp
RoundRectBackground=z
RoundRectBorder=aa
RoundRectDoubleGradientVerticalBackground=bd
RoundTabBackground=ab
ScalingImageBackground=be
SegmentTextEffect=cq
ShadowTextEffect=cr
ShuffleView=cs
SimpleBackground=ac
SimpleBorder=ad
SizeDecreaseItemView=ct
SizeIncreaseItemView=cu
SlideContainerView=cv
SmileyTextEffect=cw
SmoothColorBackground=ae
SpringContainerView=cx
SquareSonarBorder=cy
Style=cz
TachometerGaugeView=da
TextEffect=db
ThinSimpleBackground=af
TigerStripesBackground=ag
TiledImageBackground=ah
TopBorder=ai
TopBottomLeftRightBorder=aj
TranslucentRoundRectBackground=ak
TranslucentSimpleBackground=al
TriangleBackground=am
TypeWriterTextEffect=dc
VerticalBarChartView=dd
VerticalFixedContainerView=de
VerticalGradientTextEffect=df
VerticalMirrorTextEffect=dg
VideoBackground=bf
Web20RoundRectBackground=an
XmasSnowBackground=ao
