SimpleBorder=ad
ArrayList=ap
FadeInBackground=n
TopBorder=ai
TriangleBackground=am
ThinSimpleBackground=af
ImageBorder=r
PulsatingBackground=v
HorizontalStripesBackground=p
OpeningBackground=u
PulsatingCircleBackground=w
RoundTabBackground=ab
SmoothColorBackground=ae
TopBottomLeftRightBorder=aj
BottomBorder=h
GradientVerticalBackground=o
PulsatingCirclesBackground=x
BorderedSimpleBackground=g
Point=ay
CircleBackground=j
TiledImageBackground=ah
DoubleGradientVerticalBackground=au
LeftBorder=s
RoundRectBorder=aa
Properties=aq
MultiImageBorder=t
VideoBackground=be
BottomRightShadowBorder=i
Color=l
CircleBorder=k
ScalingImageBackground=bd
RoundRectDoubleGradientVerticalBackground=ba
PulsatingRoundRectBackground=ar
BorderedRoundRectOpeningBackground=e
BorderedRoundRectBackground=d
RightBorder=y
PulsatingSimpleBorder=at
TranslucentSimpleBackground=al
DropShadowBorder=m
BallBackground=b
AnimatedGifBackground=bc
ImageBackground=q
Background=a
MaskedGradientVerticalBackground=bb
Web20RoundRectBackground=an
RepaintTestBackground=ax
PulsatingRoundRectBorder=as
RoundRectBackground=z
BorderedRoundTabBackground=f
TranslucentRoundRectBackground=ak
XmasSnowBackground=ao
IntList=av
TigerStripesBackground=ag
SimpleBackground=ac
IntStack=aw
PolygonBackground=az
Border=c
