AlienGlowTextEffect=cq
AnimatedGifBackground=bx
AnimationContainerView=cr
ArrayList=by
Background=a
BallBackground=b
BinaryTextClockView=cs
Border=c
BorderedRoundRectBackground=d
BorderedRoundRectOpeningBackground=e
BorderedRoundTabBackground=f
BorderedSimpleBackground=g
BottomBorder=h
BottomRightShadowBorder=i
CarouselContainerView=ct
CircleBackground=j
CircleBorder=k
Color=l
CombinedBackground=cu
ContainerView=cv
CyclingIconsGaugeView=cw
CyclingSpheresGaugeView=cx
DoubleGradientVerticalBackground=bz
DropShadowBorder=m
DropShadowTextEffect=cz
DroppingView=cy
ExclusiveSingleLineView=da
ExplodingParticlesItemView=db
FadeInBackground=n
FadeInItemView=dc
FadeOutItemView=dd
FadeTextEffect=de
FadingAlienGlowTextEffect=df
FishEyeContainerView=dg
FlashTextEffect=dh
GradientHorizontalBackground=et
GradientVerticalBackground=o
HexTextClockView=di
HorizontalChoiceView=dj
HorizontalContainerView=dk
HorizontalGrayOutContainerView=dl
HorizontalIconsGaugeView=dm
HorizontalSpheresGaugeView=dn
HorizontalStripesBackground=p
ImageBackground=q
ImageBorder=ca
IntList=cb
IntStack=cc
ItemView=do
LeftBorder=r
LighthouseTextEffect=dp
MIDP2LayoutView=dr
MaskBackground=dq
MaskedGradientVerticalBackground=cd
MultiImageBorder=ce
NumberedContainerView=ds
OpeningBackground=s
OutlineTextEffect=dt
PartialGradientBackground=du
PartialSimpleBackground=dv
PieChartView=dw
Point=cf
PolygonBackground=cg
Properties=ch
PulsatingBackground=t
PulsatingCircleBackground=u
PulsatingCirclesBackground=v
PulsatingRoundRectBackground=ci
PulsatingRoundRectBorder=cj
PulsatingSimpleBorder=ck
RecLineGaugeView=dx
RelativeLayoutView=dy
RepaintTestBackground=cl
RightBorder=w
RotateTextEffect=dz
RotatingArcsGaugeView=ea
RotatingTextEffect=eb
RoundRectBackground=x
RoundRectBorder=y
RoundRectDoubleGradientVerticalBackground=cm
RoundTabBackground=z
ScalingImageBackground=cn
SegmentTextEffect=ec
ShadowTextEffect=ed
ShuffleView=ee
SimpleBackground=aa
SimpleBorder=ab
SizeDecreaseItemView=ef
SizeIncreaseItemView=eg
SlideContainerView=eh
SmileyTextEffect=ei
SmoothColorBackground=ac
SpringContainerView=ej
SquareSonarBorder=ek
Style=el
TachometerGaugeView=em
TextEffect=en
ThinSimpleBackground=ad
TigerStripesBackground=ae
TiledImageBackground=af
TopBorder=ag
TopBottomLeftRightBorder=ah
TranslucentRoundRectBackground=bw
TranslucentSimpleBackground=ai
TriangleBackground=co
TypeWriterTextEffect=eo
VerticalBarChartView=ep
VerticalFixedContainerView=eq
VerticalGradientTextEffect=er
VerticalMirrorTextEffect=es
VideoBackground=cp
Web20RoundRectBackground=aj
XmasSnowBackground=ak
de.enough.polish.ui.Background=al
de.enough.polish.ui.Border=bk
de.enough.polish.ui.Color=bv
de.enough.polish.ui.backgrounds.BallBackground=am
de.enough.polish.ui.backgrounds.BorderedRoundRectBackground=an
de.enough.polish.ui.backgrounds.BorderedRoundRectOpeningBackground=ao
de.enough.polish.ui.backgrounds.BorderedRoundTabBackground=ap
de.enough.polish.ui.backgrounds.BorderedSimpleBackground=aq
de.enough.polish.ui.backgrounds.CircleBackground=ar
de.enough.polish.ui.backgrounds.FadeInBackground=as
de.enough.polish.ui.backgrounds.GradientVerticalBackground=at
de.enough.polish.ui.backgrounds.HorizontalStripesBackground=au
de.enough.polish.ui.backgrounds.ImageBackground=av
de.enough.polish.ui.backgrounds.OpeningBackground=aw
de.enough.polish.ui.backgrounds.PulsatingBackground=ax
de.enough.polish.ui.backgrounds.PulsatingCircleBackground=ay
de.enough.polish.ui.backgrounds.PulsatingCirclesBackground=az
de.enough.polish.ui.backgrounds.RoundRectBackground=ba
de.enough.polish.ui.backgrounds.RoundTabBackground=bb
de.enough.polish.ui.backgrounds.SimpleBackground=bc
de.enough.polish.ui.backgrounds.SmoothColorBackground=bd
de.enough.polish.ui.backgrounds.ThinSimpleBackground=be
de.enough.polish.ui.backgrounds.TigerStripesBackground=bf
de.enough.polish.ui.backgrounds.TiledImageBackground=bg
de.enough.polish.ui.backgrounds.TranslucentSimpleBackground=bh
de.enough.polish.ui.backgrounds.Web20RoundRectBackground=bi
de.enough.polish.ui.backgrounds.XmasSnowBackground=bj
de.enough.polish.ui.borders.BottomBorder=bl
de.enough.polish.ui.borders.BottomRightShadowBorder=bm
de.enough.polish.ui.borders.CircleBorder=bn
de.enough.polish.ui.borders.DropShadowBorder=bo
de.enough.polish.ui.borders.LeftBorder=bp
de.enough.polish.ui.borders.RightBorder=bq
de.enough.polish.ui.borders.RoundRectBorder=br
de.enough.polish.ui.borders.SimpleBorder=bs
de.enough.polish.ui.borders.TopBorder=bt
de.enough.polish.ui.borders.TopBottomLeftRightBorder=bu
