BottomRightShadowBorder=i
Color=l
CircleBorder=k
SimpleBorder=ab
FadeInBackground=n
TopBorder=ag
ThinSimpleBackground=ad
BorderedRoundRectOpeningBackground=e
BorderedRoundRectBackground=d
RightBorder=w
PulsatingBackground=t
HorizontalStripesBackground=p
OpeningBackground=s
TranslucentSimpleBackground=aj
DropShadowBorder=m
BallBackground=b
ImageBackground=q
PulsatingCircleBackground=u
Background=a
RoundTabBackground=z
SmoothColorBackground=ac
Web20RoundRectBackground=ak
TopBottomLeftRightBorder=ah
RoundRectBackground=x
BottomBorder=h
BorderedRoundTabBackground=f
GradientVerticalBackground=o
TranslucentRoundRectBackground=ai
PulsatingCirclesBackground=v
XmasSnowBackground=al
TigerStripesBackground=ae
SimpleBackground=aa
BorderedSimpleBackground=g
TiledImageBackground=af
CircleBackground=j
LeftBorder=r
RoundRectBorder=y
Border=c
