AlienGlowTextEffect=a
AnimatedGifBackground=b
AnimationContainerView=c
ArrayList=d
Background=e
BallBackground=f
BinaryTextClockView=g
Border=h
BorderedRoundRectBackground=i
BorderedRoundRectOpeningBackground=j
BorderedRoundTabBackground=k
BorderedSimpleBackground=l
BottomBorder=m
BottomRightShadowBorder=n
CarouselContainerView=o
CircleBackground=p
CircleBorder=q
Color=r
CombinedBackground=s
ContainerView=t
CoverFlowContainerView=u
CyclingIconsGaugeView=v
CyclingSpheresGaugeView=w
DoubleGradientVerticalBackground=x
DropShadowBorder=z
DropShadowTextEffect=aa
DroppingView=y
ExclusiveSingleLineView=ab
ExplodingParticlesItemView=ac
FadeInBackground=ad
FadeInItemView=ae
FadeOutItemView=af
FadeTextEffect=ag
FadingAlienGlowTextEffect=ah
FishEyeContainerView=ai
FlashTextEffect=aj
GradientHorizontalBackground=ak
GradientRadialBackground=al
GradientVerticalBackground=am
HexTextClockView=an
HorizontalBackground=ao
HorizontalChoiceView=ap
HorizontalContainerView=aq
HorizontalGrayOutContainerView=ar
HorizontalIconsGaugeView=as
HorizontalSpheresGaugeView=at
HorizontalSplitBackground=au
HorizontalSplitRoundRectBackground=av
HorizontalStripesBackground=aw
ImageBackground=ax
ImageBorder=ay
IntList=az
IntStack=ba
ItemView=bb
LeftBorder=bc
LighthouseTextEffect=bd
MIDP2LayoutView=bf
MaskBackground=be
MultiImageBorder=bg
NumberedContainerView=bh
OpeningBackground=bi
OutlineTextEffect=bj
PartialGradientBackground=bk
PartialSimpleBackground=bl
PercentOrAbsoluteInteger=bm
PieChartView=bn
Point=bo
PolygonBackground=bp
Properties=bq
PulsatingBackground=br
PulsatingCircleBackground=bs
PulsatingCirclesBackground=bt
PulsatingRoundRectBackground=bu
PulsatingRoundRectBorder=bv
PulsatingSimpleBorder=bw
RecLineGaugeView=bx
RelativeLayoutView=by
RemoveTextContainerView=bz
RepaintTestBackground=ca
RightBorder=cb
RotateTextEffect=cc
RotatingArcsGaugeView=cd
RotatingTextEffect=ce
RoundRectBackground=cf
RoundRectBorder=cg
RoundRectDoubleGradientVerticalBackground=ch
RoundTabBackground=ci
ScalingImageBackground=cj
SegmentTextEffect=ck
ShadowTextEffect=cl
ShuffleView=cm
SimpleBackground=cn
SimpleBorder=co
SizeDecreaseItemView=cp
SizeIncreaseItemView=cq
SlideContainerView=cr
SlideShowBackground=cs
SmileyTextEffect=ct
SmoothColorBackground=cu
SpringContainerView=cv
SquareSonarBorder=cw
Style=cx
TableData=cy
TachometerGaugeView=cz
TextBackground=da
TextEffect=db
ThinSimpleBackground=dc
TigerStripesBackground=dd
TiledImageBackground=de
TopBorder=df
TopBottomLeftRightBorder=dg
TranslucentRoundRectBackground=dh
TranslucentRoundRectBorder=di
TranslucentSimpleBackground=dj
TriangleBackground=dk
TypeWriterTextEffect=dl
VerticalBarChartView=dm
VerticalFixedContainerView=dn
VerticalGradientTextEffect=do
VerticalMirrorTextEffect=dp
VerticalSplitBackground=dq
VerticalSplitRoundRectBackground=dr
VerticalSplitTextEffect=ds
VideoBackground=dt
Web20RoundRectBackground=du
XmasSnowBackground=dv
