AlienGlowTextEffect=db
AnimatedGifBackground=cz
AnimationContainerView=al
ArrayList=am
Background=a
BallBackground=b
BinaryTextClockView=an
Border=c
BorderedRoundRectBackground=d
BorderedRoundRectOpeningBackground=e
BorderedRoundTabBackground=f
BorderedSimpleBackground=g
BottomBorder=h
BottomRightShadowBorder=i
CarouselContainerView=ao
CircleBackground=j
CircleBorder=k
Color=l
CombinedBackground=ap
ContainerView=aq
CyclingIconsGaugeView=ar
CyclingSpheresGaugeView=as
DoubleGradientVerticalBackground=at
DropShadowBorder=m
DropShadowTextEffect=dc
DroppingView=au
ExclusiveSingleLineView=av
ExplodingParticlesItemView=aw
FadeInBackground=n
FadeInItemView=ax
FadeOutItemView=ay
FadeTextEffect=az
FadingAlienGlowTextEffect=dd
FishEyeContainerView=ba
FlashTextEffect=bb
GradientVerticalBackground=o
HexTextClockView=bc
HorizontalChoiceView=bd
HorizontalContainerView=be
HorizontalGrayOutContainerView=bf
HorizontalIconsGaugeView=bg
HorizontalSpheresGaugeView=bh
HorizontalStripesBackground=ak
ImageBackground=p
ImageBorder=bi
IntList=bj
IntStack=bk
ItemView=bl
LeftBorder=q
LighthouseTextEffect=bm
MIDP2LayoutView=bo
MaskBackground=bn
MultiImageBorder=bp
NumberedContainerView=bq
OpeningBackground=r
OutlineTextEffect=br
PartialGradientBackground=bs
PartialSimpleBackground=bt
PieChartView=bu
Point=bv
PolygonBackground=bw
Properties=bx
PulsatingBackground=s
PulsatingCircleBackground=t
PulsatingCirclesBackground=u
PulsatingRoundRectBackground=by
PulsatingRoundRectBorder=bz
PulsatingSimpleBorder=ca
RecLineGaugeView=cb
RelativeLayoutView=cc
RepaintTestBackground=cd
RightBorder=v
RotateTextEffect=de
RotatingArcsGaugeView=ce
RotatingTextEffect=df
RoundRectBackground=w
RoundRectBorder=x
RoundRectDoubleGradientVerticalBackground=cf
RoundTabBackground=y
ScalingImageBackground=cg
SegmentTextEffect=ch
ShadowTextEffect=ci
ShuffleView=cj
SimpleBackground=z
SimpleBorder=aa
SizeDecreaseItemView=ck
SizeIncreaseItemView=cl
SlideContainerView=cm
SmileyTextEffect=cn
SmoothColorBackground=ab
SpringContainerView=co
SquareSonarBorder=cp
Style=cq
TachometerGaugeView=dg
TextEffect=cr
ThinSimpleBackground=ac
TigerStripesBackground=ad
TiledImageBackground=ae
TopBorder=af
TopBottomLeftRightBorder=ag
TranslucentRoundRectBackground=cs
TranslucentSimpleBackground=ah
TriangleBackground=ct
TypeWriterTextEffect=cu
VerticalBarChartView=cv
VerticalFixedContainerView=cw
VerticalGradientTextEffect=cx
VerticalMirrorTextEffect=cy
VideoBackground=da
Web20RoundRectBackground=ai
XmasSnowBackground=aj
