AlienGlowTextEffect=bf
AnimatedGifBackground=bc
AnimationContainerView=bg
ArrayList=ap
Background=a
BallBackground=b
BinaryTextClockView=bh
Border=c
BorderedRoundRectBackground=d
BorderedRoundRectOpeningBackground=e
BorderedRoundTabBackground=f
BorderedSimpleBackground=g
BottomBorder=h
BottomRightShadowBorder=i
CarouselContainerView=bi
CarrouselContainerView=bj
CircleBackground=j
CircleBorder=k
Color=l
CombinedBackground=bk
ContainerView=bl
CoverFlowContainerView=dm
CyclingIconsGaugeView=bm
CyclingSpheresGaugeView=bn
DoubleGradientVerticalBackground=au
DropShadowBorder=m
DropShadowTextEffect=bp
DroppingView=bo
ExclusiveSingleLineView=bq
ExplodingParticlesItemView=br
FadeInBackground=n
FadeInItemView=bs
FadeOutItemView=bt
FadeTextEffect=bu
FadingAlienGlowTextEffect=bv
FishEyeContainerView=bw
FixedFocusView=bx
FlashTextEffect=by
GradientHorizontalBackground=bz
GradientRadialBackground=ca
GradientVerticalBackground=o
HexTextClockView=cb
HorizontalChoiceView=cc
HorizontalContainerView=cd
HorizontalGrayOutContainerView=ce
HorizontalIconsGaugeView=cf
HorizontalSpheresGaugeView=cg
HorizontalStripesBackground=p
ImageBackground=q
ImageBorder=r
IntList=av
IntStack=aw
ItemView=ch
LeftBorder=s
LighthouseTextEffect=ci
MIDP2LayoutView=ck
MaskBackground=cj
MaskedGradientVerticalBackground=bb
MultiImageBorder=t
NumberedContainerView=cl
OpeningBackground=u
OutlineTextEffect=cm
PartialGradientBackground=cn
PartialSimpleBackground=co
PieChartView=cp
Point=ay
PolygonBackground=az
Properties=aq
PulsatingBackground=v
PulsatingCircleBackground=w
PulsatingCirclesBackground=x
PulsatingRoundRectBackground=ar
PulsatingRoundRectBorder=as
PulsatingSimpleBorder=at
RecLineGaugeView=cq
RelativeLayoutView=cr
RepaintTestBackground=ax
RightBorder=y
RotateTextEffect=cs
RotatingArcsGaugeView=ct
RotatingTextEffect=cu
RoundRectBackground=z
RoundRectBorder=aa
RoundRectDoubleGradientVerticalBackground=ba
RoundTabBackground=ab
ScalingImageBackground=bd
SegmentTextEffect=cv
ShadowTextEffect=cw
ShuffleView=cx
SimpleBackground=ac
SimpleBorder=ad
SizeDecreaseItemView=cy
SizeIncreaseItemView=cz
SlideContainerView=da
SmileyTextEffect=db
SmoothColorBackground=ae
SpringContainerView=dc
SquareSonarBorder=dd
Style=de
TachometerGaugeView=df
TextEffect=dg
ThinSimpleBackground=af
TigerStripesBackground=ag
TiledImageBackground=ah
TopBorder=ai
TopBottomLeftRightBorder=aj
TranslucentRoundRectBackground=ak
TranslucentSimpleBackground=al
TriangleBackground=am
TypeWriterTextEffect=dh
VerticalBarChartView=di
VerticalFixedContainerView=dj
VerticalGradientTextEffect=dk
VerticalMirrorTextEffect=dl
VideoBackground=be
Web20RoundRectBackground=an
XmasSnowBackground=ao
